NO assets/textures_XPM/Bricks_Blue_Gray.xpm
SO assets/textures_XPM/Bricks_Multicolour.xpm
EA assets/textures_XPM/Bricks_Red.xpm
WE assets/textures_XPM/diagonal_squares.xpm
C 104,120,132
F 228,95,0


11111111111111111111111111111         11111111111111111111111111111111111111111
10001E00000000000000000000111         10000000000000000000000000100000000000001
10100000000000000000000000011         10000000000000000000000000000000000000001
10011111111111111111111110011         10000000000000000000000000100000000000001
10000000000000000000000010011         10000000000000000000000000111111111111101
1000000000000000000000001001111111111110000000000000000000000000000000000001001
1000000000000000000000001000000000000000000000000000000000000000100000000001001
1111111111111111111111101000000000000000000000000000000000000000100000000001001
                      101000000000000000000000000000000000000000000000000001001
                      101111111111111100000000000000000000000000100000000001001
                      100000000000000100000000000000000000000000100000000001001
                      111111111111110100000000000000000000000000000000000001001
                                   10100000000000000000000000000100000000001001
                                   10100000000000000000000000000100000000001001
                                   10111111111111111111111111111111111111111011
                                   10000000000000000000000000000000000000000011
                                   11111111111111111111111111111111111111111111