NO assets/textures_XPM/Bricks_Blue_Gray.xpm
SO assets/textures_XPM/Bricks_Multicolour.xpm
EA assets/textures_XPM/Bricks_Red.xpm
WE assets/textures_XPM/diagonal_squares.xpm
C 104,120,132
F 228,95,0


11111111111111111111111111111
11100E00000000000000000000111111111111
11100000000000000000000000011000000001
11111111111111111111111110011000100001
                        10011000101001
                        10011011111111
                        100000000011
                        111111111111
