NO assets/textures_XPM/book.xpm
SO assets/textures_XPM/bricks.xpm
EA assets/textures_XPM/wall_3.xpm
WE assets/textures_XPM/wet_sponge.xpm
C 104,120,132
F 228,95,0


11111111111111111111111111
100000000000000000000000011
1000000000000000000000000011
10000000000000000000000000011
100011111111111100000000000011
10001          100011111100001
10001          10001    100001
10001          10001    100001
10001          10001    100001
10001          10001    100001
10001111111111110001    100001
10000000000000000001    100001
10000000000000N00001    100001
10000000000000000001    100001
10001111111111110001    100001
10001          10001    100001
10001          10001    100001
10001          10001    100001
10001          10001    100001
10001          100011111100001
10001          100000000000011
10001          10000000000011
10001          1000000000011
10001          100000000011
11111          11111111111
